14 14 14 14 14 14 05 08 08 08 11 14 14 14 14 04
14 14 14 14 14 14 14 14 14 14 14 14 14 14 14 04
14 14 14 14 14 14 14 14 14 14 14 14 14 14 14 04
14 14 14 14 14 14 14 14 14 14 14 14 03 06 00 07
14 14 14 14 14 14 03 09 14 14 14 03 07 07 01 07
14 14 14 14 14 03 07 07 00 06 00 07 01 02 08 08
14 14 14 14 03 07 01 07 07 02 08 08 12 10 14 14
14 14 14 14 05 08 12 02 08 11 14 14 05 11 14 14
14 14 14 14 14 14 05 11 14 14 14 14 14 14 14 14
14 14 14 14 14 14 14 14 14 14 14 14 14 14 14 14
14 14 14 14 14 14 14 14 14 14 14 14 14 14 03 00
14 14 14 14 14 14 14 14 14 14 14 03 06 00 07 07