07 01 07 07 07 01 07 01 01 07 01 02 08 08 08 08
01 07 01 07 07 07 02 08 08 08 08 11 14 14 14 14 
08 08 08 08 08 08 11 14 14 14 14 14 14 14 14 14
14 14 14 14 14 14 14 14 14 14 14 14 14 14 14 14
14 14 14 14 14 14 14 14 14 13 14 14 14 14 14 14
14 14 14 14 14 14 14 14 14 14 14 14 14 14 14 03
14 14 14 14 14 14 14 14 14 14 14 14 14 14 14 04
09 14 14 14 14 14 14 14 14 13 14 14 14 14 14 04
10 14 14 14 14 14 14 14 14 14 14 03 06 00 06 01
10 14 14 14 14 14 14 14 03 00 06 07 07 07 01 07
10 14 14 14 03 06 06 00 07 01 01 07 01 07 07 07
10 14 14 14 04 07 07 07 01 07 01 01 07 01 07 01 