01 07 02 08 08 08 08 08 08 08 08 12 07 07 01 07
07 02 11 14 14 14 14 14 14 14 14 05 12 07 01 01
02 11 14 14 13 14 14 14 14 14 14 14 05 12 07 01
11 14 14 14 14 14 14 14 14 14 14 14 14 05 12 07
14 14 14 14 14 14 14 14 14 14 14 14 14 14 05 12
14 14 14 14 14 14 03 00 09 14 14 14 14 14 14 04
14 14 14 14 14 14 04 07 10 14 14 14 14 14 14 04
14 14 14 03 06 00 02 08 11 14 14 14 14 14 14 04
06 00 06 07 02 08 11 14 14 14 14 14 13 14 14 04
07 01 07 02 11 14 14 14 14 14 14 14 14 14 14 04
01 07 01 10 14 14 14 14 14 14 14 14 14 14 14 04
07 01 07 10 14 14 14 14 03 06 06 06 06 06 06 07