07 01 07 02 08 08 08 08 08 08 08 08 08 12 07 07
01 07 02 11 14 14 14 14 14 14 14 14 14 05 12 01
07 02 11 14 14 14 14 14 03 00 06 09 14 14 04 07
02 11 14 14 14 14 14 03 07 01 07 10 14 14 05 12
10 14 14 14 14 14 03 07 01 02 08 11 14 14 14 04
10 14 14 14 14 14 04 07 07 10 14 14 14 14 03 07
07 09 14 14 14 14 05 12 07 10 14 14 03 00 07 01
01 07 09 14 14 14 14 04 02 11 14 14 04 07 01 07
07 01 10 14 14 14 14 04 10 14 14 14 04 01 07 07
02 08 11 14 14 14 14 04 10 14 14 14 04 07 07 01
11 14 14 14 14 14 03 07 07 09 14 14 05 08 08 08
14 14 14 14 14 03 07 01 07 10 14 14 14 14 14 14 